1111111111111111
1000010C000001E1
10100100P0000101
1010000100C00101
1C10111001100101
100011100110C101
1000000C01100001
1111111111111111