111111
107001
1P0C01
1000E1
111111