111111111111111
100000000000001
100C000000P0001
100000000000001
100000000000001
100000000000001
100000000000001
100000000100001
101E01001 10001
11 11 11   1111